####################
33333333333333333333
###3333####33333####
                    
33333333333333333333
33333333333333333333
####################
###3333####33333####
###3333####33333####
333####3333#####3333
####################
33333333333333333333
###3333####33333####
                    
33333333333333333333
