                    
   //////////////   
   /            /   
   /            /   
   /  1111111!  /   
   /  1      1  /   
   /  1      1  /   
   /  1      1  /   
   /  1      1  /   
   /  1      1  /   
   /  11111111  /   
   /            /   
   /            /   
   ?/////////////   
                    
blue 16 1 - 3 13
orange 6 10 - 13 4
